version=3

size=24,24,1

tile=1,0,Sand Tile 1.bmp
tile=0,0,block.bmp
tile=8,0,floorRailE.bmp

layer=layer name,\
2,2,2,2, 2,2,2,2, 2,2,2,2, 2,2,2,2, 2,2,2,2, 2,2,2,2, \
1,1,1,1, 1,1,1,1, 1,1,1,1, 1,1,1,1, 1,1,1,1, 1,1,1,2, \
1,1,1,1, 1,1,1,1, 1,1,1,1, 1,1,1,1, 1,1,1,1, 1,1,1,2, \
1,1,1,1, 1,1,1,1, 1,1,1,1, 1,1,1,1, 1,1,1,1, 1,1,1,2, \
\
1,1,1,1, 1,1,1,1, 1,1,1,1, 1,1,1,1, 1,1,1,1, 1,1,1,2, \
1,1,1,1, 1,1,1,1, 1,1,1,1, 1,1,1,1, 1,1,1,1, 1,1,1,2, \
1,1,1,1, 1,1,1,1, 1,1,1,1, 1,1,1,1, 1,1,1,1, 1,1,1,2, \
1,1,1,1, 1,1,1,1, 1,1,1,1, 1,1,1,1, 1,1,1,1, 1,1,1,2, \
\
1,1,1,1, 1,1,1,1, 1,1,1,1, 1,1,1,1, 1,1,1,1, 1,1,1,2, \
1,1,1,1, 1,1,1,1, 1,1,1,1, 1,1,1,1, 1,1,1,1, 1,1,1,2, \
1,1,1,1, 1,1,1,1, 1,1,1,1, 1,1,1,1, 1,1,1,1, 1,1,1,2, \
1,1,1,1, 1,1,1,1, 1,1,1,1, 1,1,1,1, 1,1,1,1, 1,1,1,2, \
\
1,1,1,1, 1,1,1,1, 1,1,1,1, 1,1,1,1, 1,1,1,1, 1,1,1,2, \
1,1,1,1, 1,1,1,1, 1,1,1,1, 1,1,1,1, 1,1,1,1, 1,1,1,2, \
1,1,1,1, 1,1,1,1, 1,1,1,1, 1,1,1,1, 1,1,1,1, 1,1,1,2, \
1,1,1,1, 1,1,1,1, 2,2,2,2, 2,2,2,2, 2,2,2,2, 2,1,1,2, \
\
1,1,1,1, 1,1,1,1, 3,3,3,3, 3,3,3,3, 3,3,3,1, 1,1,1,2, \
1,1,1,1, 1,1,1,1, 3,3,3,3, 3,3,3,3, 3,3,3,1, 1,1,1,2, \
1,1,1,1, 1,1,1,1, 2,2,2,2, 2,2,2,2, 2,2,2,2, 2,1,1,2, \
1,1,1,1, 1,1,1,1, 1,1,1,1, 1,1,1,1, 1,1,1,1, 1,1,1,2, \
\
1,1,1,1, 1,1,1,1, 1,1,1,1, 1,1,1,1, 1,1,1,1, 1,1,1,2, \
1,1,1,1, 1,1,1,1, 1,1,1,1, 1,1,1,1, 1,1,1,1, 1,1,1,2, \
1,1,1,1, 1,1,1,1, 1,1,1,1, 1,1,1,1, 1,1,1,1, 1,1,1,2, \
2,2,2,2, 2,2,2,2, 2,2,2,2, 2,2,2,2, 2,2,2,2, 2,2,2,2
