version=3

# size=sizeX,sizeY,layerCount
# sizes in number of tiles, not in actual coordinates.
size=24,24,2

# Tile declarations define the pallet. order is significant.
# tile=shape,surface,graphicId
# For meaning of shape and surface see Tile.h.
# graphicId can be a bitmap, an animation, or blank.
# There is an implicit tile declaration in position 0 of every pallet:
# tile=0,0,
# which is black nothingness. The rest of the pallet is 1-based.
tile=1,0,Sand Tile 1.bmp
tile=0,0,block.bmp
tile=3,0,Sand Block NW.bmp
tile=4,0,Sand Block NE.bmp
tile=5,0,Sand Block SE.bmp
tile=6,0,Sand Block SW.bmp
tile=0,0,block.bmp
tile=8,0,floorRailE.bmp
tile=10,0,floorRailW.bmp

# Layer declarations are always full arrays (no sparse allowed).
# Flatten a 2d grid in row-major order. 
# There must be (sizeX*sizeY) comma delimitted tile indexes.
# layer=layer name,0,0,...
layer=layer name,\
2,2,2,2, 2,2,2,2, 2,2,2,2, 2,2,2,2, 2,2,2,2, 2,2,2,2, \
2,1,1,1, 1,1,1,1, 1,1,1,1, 1,1,1,1, 1,1,1,1, 1,1,1,2, \
2,1,1,1, 1,1,1,1, 1,1,1,1, 1,1,1,1, 1,1,1,1, 1,1,1,2, \
2,1,1,1, 1,1,1,1, 1,5,2,3, 1,1,1,1, 1,1,1,1, 1,1,1,2, \
\
2,1,1,1, 1,1,1,1, 5,2,3,1, 1,1,1,1, 1,1,4,6, 1,1,1,2, \
2,1,1,1, 1,1,1,1, 2,3,1,1, 1,1,1,1, 1,1,1,2, 6,1,1,1, \
2,1,1,1, 1,1,1,1, 3,1,1,1, 1,1,1,1, 1,1,5,2, 2,6,1,1, \
2,1,1,1, 1,1,1,1, 1,1,1,1, 1,6,1,5, 1,1,1,1, 1,1,1,1, \
\
2,1,1,1, 1,1,1,1, 1,1,1,1, 1,1,1,1, 1,1,1,1, 1,1,1,2, \
2,1,1,1, 1,1,1,1, 1,8,9,1, 1,1,1,1, 1,1,1,1, 1,1,1,2, \
2,1,1,1, 1,1,1,1, 1,8,9,1, 1,3,1,1, 4,1,1,1, 1,1,1,1, \
2,1,1,1, 1,1,1,1, 1,8,9,1, 1,1,1,1, 1,1,1,1, 1,1,1,1, \
\
2,1,1,1, 1,1,1,1, 1,8,9,1, 1,1,1,1, 1,1,1,1, 1,1,1,1, \
2,2,1,1, 1,1,1,1, 1,8,9,1, 1,6,1,1, 5,1,1,1, 1,1,1,1, \
2,2,2,1, 1,1,1,1, 1,1,1,1, 1,1,1,1, 1,1,1,1, 1,1,1,2, \
2,2,1,1, 1,1,1,1, 1,1,1,1, 1,1,1,1, 1,1,1,1, 1,1,1,2, \
\
2,1,1,1, 1,1,1,1, 1,1,1,1, 1,1,1,1, 1,1,1,1, 1,1,1,1, \
2,1,1,1, 1,1,1,1, 1,1,1,1, 1,1,1,1, 1,1,1,1, 1,1,1,1, \
2,1,1,1, 1,1,1,1, 1,1,1,1, 1,1,1,1, 1,1,1,1, 1,1,1,1, \
2,1,1,1, 2,1,1,1, 1,1,1,1, 1,1,1,1, 1,1,1,1, 1,1,1,1, \
\
2,1,1,1, 1,1,1,1, 1,1,1,1, 1,1,1,1, 1,1,1,1, 1,1,1,1, \
2,1,1,1, 1,1,1,1, 1,1,1,1, 1,1,1,1, 1,1,1,1, 1,1,1,2, \
2,1,1,1, 1,1,1,1, 1,1,1,1, 1,1,1,1, 1,1,1,1, 1,1,1,2, \
2,2,2,2, 1,2,2,2, 2,2,2,2, 2,2,2,2, 2,2,2,1, 1,2,2,2

layer=another layer name,\
0,0,0,0, 0,0,0,0, 0,0,0,0, 0,0,0,0, 0,0,0,0, 0,0,0,0, \
0,0,0,0, 0,0,0,0, 0,0,0,0, 0,0,0,0, 0,0,0,0, 0,1,1,0, \
0,0,0,0, 0,0,0,0, 0,0,0,0, 0,0,0,0, 0,0,0,0, 0,2,1,0, \
0,0,0,0, 0,0,0,0, 0,0,0,0, 0,0,0,0, 0,0,0,0, 0,0,0,0, \
\
0,0,0,0, 0,0,0,0, 0,0,0,0, 0,0,0,0, 0,0,0,0, 0,0,0,0, \
0,0,0,0, 0,0,0,0, 0,0,0,0, 0,0,0,0, 0,0,0,0, 0,0,0,0, \
0,0,0,0, 0,0,0,0, 0,0,0,0, 0,0,0,0, 0,0,0,0, 0,0,0,0, \
0,0,0,0, 0,0,0,0, 0,0,0,0, 0,0,0,0, 0,0,0,0, 0,0,0,0, \
\
0,0,0,0, 0,0,0,0, 0,0,0,0, 0,0,0,0, 0,0,0,0, 0,0,0,0, \
0,0,0,0, 0,0,0,0, 0,0,0,0, 0,0,0,0, 0,0,0,0, 0,0,0,0, \
0,0,0,0, 0,0,0,0, 0,0,0,0, 0,0,0,0, 0,0,0,0, 0,0,0,0, \
0,0,0,0, 0,0,0,0, 0,0,0,0, 0,0,0,0, 0,0,0,0, 0,0,0,0, \
\
0,0,0,0, 0,0,0,0, 0,0,0,0, 0,0,0,0, 0,0,0,0, 0,0,0,0, \
0,0,0,0, 0,0,0,0, 0,0,0,0, 0,0,0,0, 0,0,0,0, 0,0,0,0, \
0,0,0,0, 0,0,0,0, 0,0,0,0, 0,0,0,0, 0,0,0,0, 0,0,0,0, \
0,0,0,0, 0,0,0,0, 0,0,0,0, 0,0,0,0, 0,0,0,0, 0,0,0,0, \
\
0,0,0,0, 0,0,0,0, 0,0,0,0, 0,0,0,0, 0,0,0,0, 0,0,0,0, \
0,0,0,0, 0,0,0,0, 0,0,0,0, 0,0,0,0, 0,0,0,0, 0,0,0,0, \
0,0,0,0, 0,0,0,0, 0,0,0,0, 0,0,0,0, 0,0,0,0, 0,0,0,0, \
0,0,0,0, 0,0,0,0, 0,0,0,0, 0,0,0,0, 0,0,0,0, 0,0,0,0, \
\
0,0,0,0, 0,0,0,0, 0,0,0,0, 0,0,0,0, 0,0,0,0, 0,0,0,0, \
0,0,0,0, 0,0,0,0, 0,0,0,0, 0,0,0,0, 0,0,0,0, 0,0,0,0, \
0,0,0,0, 0,0,0,0, 0,0,0,0, 0,0,0,0, 0,0,0,0, 0,0,0,0, \
0,0,0,0, 0,0,0,0, 0,0,0,0, 0,0,0,0, 0,0,0,0, 0,0,0,0


#layer = 1,1, 1,1
#layer = 0,2, 2,0

# submap declarations yet to come. most likely like this:
# submap=x,y,localId,resourceId

# trigger declarations yet to come.
# trigger=???

# entity declarations yet to come.
# entity=x,y,layer,id
entity=256,256,0,rock.entity
entity=223,256,0,rock.entity
entity=190,256,0,rock.entity
entity=157,256,0,rock.entity
entity=124,256,0,rock.entity
